18,18,18,18,18,18,18,18,18,18,18,18,18,18,18,18,18,18,18,18,18
35,7,18,18,18,18,18,18,18,18,18,18,18,18,18,18,18,18,6,35,35
103,34,35,7,18,18,18,18,18,6,35,35,35,35,7,18,18,18,19,103,103
120,120,120,34,35,35,35,35,35,36,120,120,120,120,34,35,35,35,36,120,120
120,120,120,120,120,120,120,120,120,120,120,120,120,120,120,120,120,120,120,120,120
120,120,120,120,120,120,120,120,120,120,120,120,120,120,120,120,120,120,120,120,120
120,120,120,120,120,120,120,120,120,120,120,120,120,120,120,120,120,120,120,120,120
120,120,120,120,120,120,120,15,69,69,16,120,120,0,1,1,66,70,120,120,120
120,120,120,120,0,1,66,33,120,120,38,120,120,9,35,35,36,120,120,120,120
120,120,120,15,84,35,36,120,120,120,120,120,120,38,120,120,120,108,137,137,109
120,120,68,33,120,120,120,120,120,120,120,120,120,120,120,120,120,121,0,2,119
120,120,120,120,120,120,120,108,137,137,109,120,120,120,120,108,137,138,17,19,119
120,120,120,120,120,120,120,121,0,2,119,120,120,108,137,138,0,1,24,19,119
120,108,137,137,137,137,137,138,17,19,136,137,137,138,0,1,24,18,18,19,119
108,138,0,1,1,1,1,1,24,23,1,1,1,1,24,18,18,18,18,19,119
121,0,24,18,18,18,18,18,18,18,18,18,18,18,18,18,18,18,18,19,119