18,18,18,18,18,18,18,18,18,18,18,18,18,18,18,18,18,18,18,18,18
35,7,18,6,35,35,35,35,35,35,35,35,35,35,35,35,35,35,58,35,35
103,17,18,19,103,103,103,103,103,103,103,103,103,103,103,103,103,103,21,103,103
120,17,6,36,120,120,120,120,120,120,120,120,120,120,120,120,68,67,27,120,120
120,9,36,120,120,120,120,120,120,120,120,120,120,120,120,120,120,34,36,120,120
120,21,120,120,120,120,120,120,120,120,120,120,120,120,120,120,120,120,120,120,120
120,38,120,120,120,120,120,120,120,120,120,120,120,120,120,120,120,120,120,120,120
120,120,120,120,120,120,120,120,120,120,120,120,68,67,66,70,120,120,120,120,120
120,120,120,120,120,120,120,4,120,120,120,120,120,34,36,120,120,120,120,120,120
120,120,120,120,120,120,68,60,70,120,120,120,120,120,120,120,120,120,120,120,120
120,120,120,120,120,120,120,38,120,120,120,120,120,120,120,120,120,4,120,120,120
120,120,120,120,4,120,120,120,120,120,120,120,120,120,120,120,0,27,120,120,120
120,120,120,15,33,120,120,120,120,120,120,120,120,120,120,120,17,19,120,120,120
120,120,120,21,137,137,137,4,137,137,137,137,137,137,137,0,24,19,137,120,120
120,120,0,75,1,1,1,75,1,1,1,1,1,1,1,24,18,23,2,120,120
120,0,24,18,18,18,18,18,18,18,18,18,18,18,18,18,18,18,23,2,120