18,18,18,18,18,18,18,18,18,18,18,18,18,18,18,18,18,18,18,18,18
35,35,35,35,7,18,18,18,18,18,6,35,35,35,35,7,18,18,6,35,35
103,103,103,103,17,18,18,18,18,18,19,103,103,103,103,34,35,7,19,103,103
120,120,120,120,17,18,18,18,18,6,36,120,120,120,120,120,120,34,36,120,120
120,120,120,120,34,35,35,35,35,36,120,120,120,120,120,120,120,120,120,120,120
120,120,120,120,120,120,120,120,120,120,120,120,120,120,120,120,120,120,120,120,120
120,120,120,120,120,120,120,120,120,120,120,120,120,120,120,120,120,120,120,120,120
120,120,120,120,120,120,120,120,120,120,120,120,120,120,120,120,120,120,120,120,120
120,120,120,120,120,120,120,120,120,120,120,120,120,120,120,120,120,120,120,120,120
120,120,68,70,120,120,120,120,120,120,120,120,120,120,120,120,120,120,120,120,120
120,120,120,120,120,120,120,120,120,120,120,120,120,120,120,120,120,120,120,120,120
120,120,120,120,120,120,120,120,120,120,120,120,120,120,68,70,120,120,120,120,120
120,120,120,120,120,120,120,120,120,120,120,120,120,120,120,120,120,120,120,120,120
120,120,120,120,120,120,120,120,0,1,2,120,120,120,120,120,120,120,120,120,120
120,0,1,2,120,120,120,0,24,18,23,2,120,120,120,120,120,0,1,2,120
120,17,18,23,2,120,120,17,18,18,18,23,1,1,2,120,120,17,18,19,120