18,18,18,18,18,18,18,18,18,18,18,18,18,18,18,18,18,18,18,18,18
18,6,35,35,35,35,35,35,35,35,35,35,35,35,35,35,35,35,35,35,35
18,19,102,103,103,103,103,103,103,103,103,103,103,103,103,103,103,103,103,103,103
18,19,119,120,120,120,120,120,120,120,120,120,120,120,120,120,120,120,120,120,120
18,19,119,120,120,120,120,120,120,120,120,120,120,120,120,120,120,120,120,120,120
18,19,119,120,120,120,120,120,120,120,120,120,120,120,120,120,120,120,120,120,120
18,19,119,120,120,120,120,120,120,120,120,120,120,120,120,120,120,120,120,120,120
18,19,119,120,120,120,120,120,120,120,120,120,120,120,120,120,120,120,120,120,120
18,19,119,120,120,120,120,120,120,120,120,120,120,120,120,120,120,120,120,120,120
18,19,119,120,120,120,120,120,120,120,120,120,120,120,120,120,120,120,120,120,120
35,36,119,120,120,120,120,120,120,120,120,120,120,120,120,120,120,120,120,120,120
103,103,126,120,120,120,120,120,120,120,120,120,120,120,120,120,120,120,120,120,120
120,120,120,120,120,120,120,120,120,120,120,120,120,120,120,120,120,120,120,120,120
137,137,137,137,137,137,137,137,137,137,137,137,137,137,137,137,137,137,137,137,109
1,1,1,1,1,1,1,1,1,1,1,1,1,1,1,1,1,1,1,2,119
18,18,18,18,18,18,18,18,18,18,18,18,18,18,18,18,18,18,18,19,119