18,18,18,18,18,18,18,18,18,18,18,18,18,18,18,18,18,18,18,18,18
35,35,35,35,35,35,35,35,35,35,35,35,35,35,35,35,35,35,35,35,35
103,103,103,103,103,103,103,103,103,103,103,103,103,103,103,103,103,103,103,103,103
120,120,120,120,120,120,120,120,120,120,120,120,120,120,120,120,120,120,120,120,120
120,120,120,120,120,120,120,120,120,120,120,120,120,120,120,120,120,120,120,120,120
120,120,120,120,120,120,120,120,120,120,120,120,120,120,120,120,120,120,120,120,120
120,120,120,120,120,120,120,120,120,120,120,120,120,120,120,120,120,120,120,120,120
120,120,120,120,120,120,120,120,120,120,120,120,120,120,120,120,120,120,120,120,120
120,120,120,120,120,120,120,120,120,120,120,120,120,120,120,120,120,120,15,70,120
120,72,120,120,120,120,120,120,120,120,120,0,1,1,1,1,1,1,27,120,120
120,120,120,120,120,120,120,120,120,120,120,34,35,35,35,35,35,35,10,120,120
120,120,120,120,72,120,120,120,120,72,120,120,120,120,120,120,120,120,32,70,120
120,120,120,120,120,120,120,120,120,120,120,120,120,120,120,120,120,120,120,120,120
108,137,137,137,137,137,137,72,137,137,137,137,137,137,137,137,137,137,137,137,109
121,68,69,69,67,1,1,1,1,1,1,1,1,1,1,1,1,1,1,2,119
125,103,103,104,17,18,18,18,18,18,18,18,18,18,18,18,18,18,18,19,119